##############
###      P  ##
##O  X       #
#O    O X   ##
#            #
#            #
#X       #####
##############